Códigos de GTA San Andreas PC

AEDUWNV:  nunca mais sinta fome
AEZAKMI: anula o nível de procurado
AFPHULTL: ativa um tema ninja
AFSNMSMW: ativa barcos voadores
AFZLLQLL: game com céu limpo
AGBDLCID: materializa o Monster
AIWPRTON: materializa o Rhino
AIYPWZQP: ganhe um paraquedas
AJLOJYQY: todos os pedestres se atacam com tacos de golfe
AKJJYGLC: materializa o Quad
ALNSFMZO: jogo com tempo nublado
AMOMHRER: materializa o Tanker Truck
AQTBCODX: materializa o Romero
ASBHGRB: todo mundo fica igual ao Elvis
AUIFRVQS: game com tempo chuvoso
BAGUVIX: torna a saúde infinita
BEKKNQV: atrai as mocinhas que prestam serviço nas ruas
BGKGTJH: todo o tráfego é formado por carros baratos
BGLUAWML: pedestres se atacam com diversas armas
BMTPWHR: veículos e pedestres do campo
BSXSGGC: quando atingidos, os carros flutuam
BTCDBCB: faz o protagonista ficar gordo
CFVFGMJ: tempo do jogo com neblina
CIKGCGX: todos com roupas de banho
COXEFGU: todos os carros têm nitro
CPKTNWT: explode todos os carros
CQZIJMB: materializa o Bloodring Banger
CVWKXAM: oxigênio infinito
CWJXUOC: faz surgir areia
EEGCYXT: materializa o Dozer
FOOOXFT: todo mundo armado
FVTMNBZ: todo o tráfego é formado por veículos do campo
GUSNHDE: todo o tráfego é formado por carros rápidos
HESOYAM: ganhe vida, um colete e 250 mil dólares ao mesmo tempo
IAVENJQ: ativa o Mega Soco
IOJUFZN: perturba a ordem pública
IOWDLAC: todo o tráfego fica negro
JQNTDMH: materializa o Rancher
JUMPJET: materializa a Hydra
JYSDSOD: aumenta os músculos
KGGGDKP: materializa o Vortex
KJKSZPJ: receba o pacote de armas profissionais
KRIJEBR: materializa o Stretch
KVGYZQK: faz o protagonista ficar magrelo
LFGMHAL: ativa o Mega Salto
LIYOAAY: deixa todo o jogo mais lento
LJSPQK: aumenta o nível de procurado para 6 estrelas
LLQPFBN: todo o tráfego fica rosa
LXGIWYL: dá outro pacote de artilharia pesada
MGHXYRM: tempo nervoso
MROEMZH: todo mundo é membro de algum dos grupos que controlam a cidade
MUNASEF: modo Adrenalina (tudo fica em câmera lenta)
NCSGDAG: nível máximo em todas as artilharias
OGXSDAG: eleva o respeito ao valor máximo
OHDUDE: materializa o Hunter
OSRBLHH: aumenta o nível de procurado em 2 estrelas
OUIQDMW: permite usar a mira enquanto dirige
PDNEJOH: materializa o Racecar
PGGOMOY: habilita a direção perfeita
PPGWJHT: todo o jogo fica mais rápido
PRIEBJ: ativa o tema Funhouse
RIPAZHA: ativa carros voadores
RZHSUEW: materializa o Caddy (carrinho de golfe)
SJMAHPE: recruta qualquer um com pistola 9 mm
SZCMAWO: CJ se mata
THGLOJ: reduz o tráfego
UBHYZHQ: materializa o Trashmaster (carro do lixo)
URKQSRK: materializa o Stunt Plane
UZUMYMW: mais um código para pacote de equipamentos
VKYPQCF: todos os táxis têm nitro e saltam ao buzinar
VPJTQWV: materializa outro Racecar
VQIMAHA: maximiza todas as skills de todos os veículos
WANRLTW: torna a munição infinita (não há necessidade de recarregar)
XICWMD: deixa o carro invisível
XJVSNAJ: sempre é meia-noite no jogo
YECGAA: ativa o JetPack (um dos melhores equipamentos)
YLTEICZ: motoristas ficam nervosos
YSOHNUL: o tempo passa mais rápido
ZEIIVG: todas as luzes ficam verdes
ZSOXFSQ: recruta qualquer um com foguetes